* * * * * * * * * * * * *
* * * * * * * * * * * * *
* * * * * * * * * * * * *
* * * * * * * * * * * * *
b * r * g * t * g * r * b
b * r * g * t * g * r * b
b * r * g * t * g * r * b
b * r * g * t * g * r * b
b * r * g * t * g * r * b
b * x o x o x o x o x * b
b * r * g * t * g * r * b
b * r * g * t * g * r * b
b * r * g * t * g * r * b
b * r * g * t * g * r * b
o * o * o * o * o * o * o
b * r * g * t * g * r * b
* * * * * * * * * * * * *
* * * * * * * * * * * * *
* * * * * * * * * * * * *
* * * * * * * * * * * * *
* * * * * * * * * * * * *
* * * * * * * * * * * * *
* * * * * * * * * * * * *
* * * * * * * * * * * * *
* * * * * * * * * * * * *