* * * * * * * * * * * * *
* * * * * * * * * * * * *
* * * * * * * * * * * * *
* * * * * * * * * * * * *
* * x x x x x x x x x * *
* * g r b p x p b r g * *
* * g r b p x p b r g * *
* * g r b p x p b r g * *
* * g r b p y p b r g * *
* * g r b p x p b r g * *
* * g r b p x p b r g * *
* * g r b p x p b r g * *
* * x x x x x x x x x * *
* * * * * * * * * * * * *
* * * * * * * * * * * * *
* * * * * * * * * * * * *
* * * * * * * * * * * * *
* * * * * * * * * * * * *
* * * * * * * * * * * * *
* * * * * * * * * * * * *
* * * * * * * * * * * * *
* * * * * * * * * * * * *
* * * * * * * * * * * * *
* * * * * * * * * * * * *
* * * * * * * * * * * * *