* * * * * * * * * * * * *
* * * * * * * * * * * * *
* * * * * * * * * * * * *
* * * * * * * * * * * * *
y y y y y y y y y y y y y
y y y y y y y y y y y y y
* * * * * * * * * * * * *
r r x * x r r r x * x r r
r r x * x r r r x * x r r
r r x * x r r r x * x r r
r r x * x r r r x * x r r
* * * * * * * * * * * * *
w w w w w w w w w w w w w
w w w w w w w w w w w w w
* * * * * * * * * * * * *
* * * * * * * * * * * * *
* * * * * * * * * * * * *
* * * * * * * * * * * * *
* * * * * * * * * * * * *
* * * * * * * * * * * * *
* * * * * * * * * * * * *
* * * * * * * * * * * * *
* * * * * * * * * * * * *
* * * * * * * * * * * * *
* * * * * * * * * * * * *